11111111111111111111111111
11000000100000000C00000001
10000000P00000000000000001
10000000100000000000000001
10000000100000000000000001
10000000100000000000000001
100000011E0000000000100011
1000001010000C000001C00011
11111111111111111111111111